10 15
| | | | | | |X| | |X|X| | | |X|
| |X| | | | | | | | |X|X| |X|X|
| | | |X| | | | | | |X|X|X| | |
| |X|X| | | | |X| |X| | | | |X|
|X|X| |X| | | | |X|X| |X|X| |X|
|X| | |X| | | |X| |X| |X| |X| |
| |X| |X|X| |X|X| |X| | | |X| |
|X|X| |X| | | | | | | |X| |X| |
| |X| | |X| | | |X|X|X| | | |X|
|X| | | | | | |X| |X|X|X|X| | |
