50 50
| | | | | | | |X| | | |X| | | | | |X| | | | | | |X| | | |X|X|X| |X| | | | | | | |X| |X| | |X| | |X| |
| | | |X|X| |X| | | |X|X| | | | |X| | |X| | |X| |X|X| |X| | | |X|X| | | | | | | |X| | |X| |X|X| |X|X|
| | | |X|X| | | | | | |X|X| | |X| | | | | |X| |X| | | |X| |X| | | | |X| | |X|X| | |X| |X| |X| | | | |
| |X| |X| | | |X|X| | |X| | | |X| | | |X| | | | |X| |X|X|X| | | | | |X| | |X| | | |X| |X|X|X| | | |X|
| | | | |X| | | |X|X| | | | | |X|X|X|X| | | |X| | | | | | |X|X|X|X| | | | |X| | |X| |X| | |X| | | | |
| | |X| | |X|X|X| | | | | |X| | | | | | | | | | | | | | | | | | |X| |X| | |X|X| |X|X| |X| | |X| | | |
| | | |X| | | | | | | | | | | |X|X| |X| | |X| | | | |X| | | | | | |X| |X| | | | | | |X| | | | |X| |X|
| | | |X| |X| | | | | | |X|X|X| | | | | | | | | | | |X|X| |X|X| | | | | |X| |X| | | |X| | | |X| | | |
| | |X| | | | | | | | | | |X| | | |X| | | |X|X|X| | | | | | | |X| |X|X|X| |X| |X| |X| | | | | |X| | |
| |X| | | | |X| | |X| | | | | | | | |X| |X| | | | | |X| | |X| |X| | | | | | | | | | |X| | | |X|X| | |
| | |X|X| | | | | |X| |X| |X|X|X|X|X|X| | | | | | | | | | | | | | |X| | | | | | |X| | |X| | | |X|X| |
| | | | | |X| | | | | |X|X| |X|X| | | | |X| |X| |X|X|X|X| | | | | | |X| | | | |X| | | |X| | | |X|X|X|
|X|X| | | | | | | | |X| |X| | | | | | | | | | |X|X|X|X|X| | | | | | | | | | |X| | | | | |X| |X| | |X|
| | | |X| | |X| | |X|X|X| | | |X| | |X|X| | |X| | | | |X|X| | | | |X| |X| |X|X|X| | | | | |X| | | | |
|X| | |X| | | |X| | |X| | |X| | | | | | | |X|X| | |X| | | | | |X| | |X|X| |X|X|X| | | | | | | | | |X|
|X|X|X| |X|X| |X| | | | | |X| | | | | | |X|X|X| |X| |X| | | | |X|X| | | | |X| | | | | | |X| |X| |X|X|
| |X|X| | | | |X| | | | |X| | | | | | | | | |X| | | | |X| | | | | |X| | |X| | | | | | | |X|X|X| | | |
| | | | | |X| | | | | | | | | | | | | | | |X| | | | | | | | | |X|X| | | |X| | | |X|X| | | |X| | | | |
|X| | | | | | | |X| | | | | | |X| | |X|X| | |X| | | |X| |X| | | | |X| | | | | |X|X| |X| |X| | |X| |X|
|X|X|X| | | | |X| | |X| | | | |X| |X| | | | | |X| | |X| | |X|X| |X| | | |X| | |X| | |X|X| |X|X|X| | |
| | | |X| | |X| |X|X| | |X| | |X| | | | | | | | | | |X| | | | | |X|X| | | | | | |X|X|X| | | |X|X| |X|
|X| | | | |X| |X| | |X| | | | | | | | |X| |X| | |X| |X|X|X| | | |X| |X| | | | | |X|X| |X|X|X|X|X| |X|
| | |X|X|X|X|X| | | | |X| | | |X| | | | | | | | | | | |X| | | |X| | | | | |X| |X|X|X| | | | | | |X| |
|X| | |X| | |X| | | | |X|X|X|X| |X| | |X|X| | | |X| | |X| |X| | |X| | |X| | |X|X| | | |X|X| | | | | |
| |X| | | |X| | | | |X| | | |X|X| | |X| | | | |X| | | | | | | | | |X| | |X|X| | | | | | | |X|X| |X| |
| | | | | | | | | |X| | | |X|X| | | | | |X| |X| | |X| | | | |X| | | | | |X|X| |X| | |X| | | | | | |X|
|X| | | | | |X| | | | |X| | | |X|X| | |X| |X| | | | | | | | | |X| | | |X| | | | | | |X| | | | | |X|X|
| | |X|X| | | | | | |X| | |X| | | | |X|X| |X| | | |X| | | |X| | | |X| |X| | | |X| | | | | | | | | |X|
|X| |X| |X|X| | | | |X| |X| | |X| | | | |X| | | |X|X|X| | | | | | | | | |X| | |X| | |X|X|X| | | | | |
| | |X|X| | | | | | | | | | | |X| |X| | | | | |X|X|X|X| | | | |X| | | | | |X| | | | | |X|X|X| | | | |
| | | |X|X|X| | |X| | | |X| | |X| | | | | | |X| | | | | | |X| |X| | | |X|X| | |X| |X| | | |X| | |X| |
| |X| |X|X| |X| | | | | | | | |X| | |X|X| | | |X| | |X|X| |X|X| |X| | | |X| | | | |X| | |X| |X| |X| |
| | | |X| | | | |X| | | |X| | | | | | |X| | |X|X|X|X| | | | | | | |X|X|X| | |X| | | | | | | | |X| | |
| | | | | | | |X|X|X| |X|X| | | | |X|X| | | |X| | | | |X|X|X| | | |X|X| | | | | |X| | | | | | | |X|X|
|X| | | | | |X|X| |X| |X| | | | | | | | | | | | |X|X| | |X| | |X| | |X| |X| | | |X| |X|X|X| | | | |X|
| | | |X|X| | | | | | | | | | | |X| | | | |X| |X|X| |X|X| |X| | |X| |X|X| | | | | | | | | | |X| | |X|
|X|X| |X| | | | | | | | | |X| | | |X|X| | |X| | | | | |X| | | | | | | | |X| | |X|X| | | |X| | | | | |
| | |X| | | | |X| | | | |X| | | | | |X|X|X| | |X| |X|X| |X| | | | |X|X| | |X| | |X|X| |X| | |X|X| | |
| | | | |X| | |X|X| | | | | | | | | | | |X| |X| | | |X|X| | |X|X| |X| | | | | | |X| | |X| | | | |X| |
|X| | | | | | | | |X| |X|X|X|X| | | | |X| | |X| | | | |X| |X|X|X| | | |X| | | |X| | | | |X| | | | | |
|X|X| |X| | | | | | | | | | | | | |X|X| | | | |X|X| | | | |X| | | | |X| |X|X|X|X| |X| | | |X| | |X|X|
|X| | |X| | | | | | |X| | | |X|X| | | |X| |X| | | | |X| |X| |X| | |X|X| | |X| | | | | | | | | | | | |
| | | | | |X| |X| | | | | | | | | |X| |X| | |X| | | | | |X| | | |X|X| | | | |X|X|X| |X| |X|X|X| | |X|
| | | |X| | | |X| |X| | | | | | |X| | | |X| | |X| | |X| | | | | | | | |X|X| |X| | | | |X| | | |X| | |
| | |X|X|X| | | | |X| |X|X|X|X| | | | | | | | |X| | |X|X| |X| |X|X| | |X| | | |X| | | | |X| |X| | |X|
|X| | | | | |X| |X| | |X|X| | | | | | |X| | |X| | | | | | | | | |X|X| | | |X| |X| | | | |X| | |X| |X|
|X| |X| | | | | | | | |X| | | | | |X| |X| | | | |X| | | | |X| |X| | | |X| | | | | |X| | | | | |X| |X|
| | |X| | | |X| |X|X| |X| | | | | | | | |X| | | | | | |X|X| | | |X| | |X|X| | | | |X| | | | | | | | |
| | | | | |X| | | | | | |X| | | |X| | | | | |X| | |X| | |X|X| |X|X|X| |X| |X| | | |X| | |X| | | | |X|
| | | | | |X| | | |X|X| | |X| | |X| | | | | | |X| | |X|X|X| | | | | | |X|X| | |X|X| | |X| | | | | | |
